^^^^^^^^^^^^^
^----#X|-|||^
^----##|-|||^
^----##|-|||^
^----##|-|||^
^----##|-|||^
^----##|-|||^
^----##|-|||^
^----##|-|||^
^----#O|-|||^
^^^^^^^^^^^^^
