####################
#||##X---^##||##---#
#||##-##^-##||##-#-#
#||-----#^--||--#--#
#||##-###-##||##---#
#||##-----##||##-O-#
####################
