^^^^^^^^^^^^^^^^^^
^###||####||####|^
^###||####||####|^
^#--||--##||--##|^
^#||####||####||#^
^#||####||####||#^
^#||--##||--##||#^
^#||##||####||##|^
^#||##||####||##|^
^#||##||--##||##|^
^#||##||##||##||#^
^#||##||##||##||#^
^#||##||##||##||#^
^#||##||##||##||#^
^O||##||##||##||X^
^^^^^^^^^^^^^^^^^^
