##################^
#O#--#--#--#--#---^
#-#--#||#--#||#---^
#-#--#--#--#--#---^
#-#||#--#--#--#||-^
#-#--#--#--#--#---^
#-#--#||#--#||#---^
#-#--#--#--#--#---^
#-#||#--#--#--#||-^
#-#--#--#--#--#---^
#-#--#||#--#||#---^
#-#--#--#--#--#---^
#-#||#--#--#--#||-^
#-#--#--#--#--#---^
#-#--#||#--#||#---^
#-#--#--#--#--#---^
#-#||#--#--#--#||-^
#################X^
^^^^^^^^^^^^^^^^^^^